##########################################                
#                                        #                
#  ##############################        #                
#     #####                     #        #                
#       ######                  #        #                
#        ######                 #        #                
#              ##############   #        #                
#             ##            #   #        #                
#             #  ########   #   #        #                
#             #  ########   #   #        #                
#             #  ########   #   #        #                
#             #  ########   #   #        #                
#             #  ########   #   #        #                
#             #  ########   #   #        #                
#             #  ########   #   #        #                
#             #  ########   ### #        #                
#             #                 #        #                
#             ###################        #                
#     #####                              #                
#       ######                           #                
#        ########                        #                
#                                        #                
##########################################                
 
