##########################################                
#                                        #                
#  ##############################        #                
#     #####                     #        #                
#       ######                  #        #                
#        ######                 #   [    #                

#              ##############   #        #                
#             ##            #   #        #                
#             #  ########   #   #        #                
#             #  ########   #   #        #                
#     [       #  ########   #   #        #                
#             #  ########   #   #        #                

#             #  ########   #   #        #                
#             #  ########   #   #   ]    #                
#             #  ########   #   #        #                
#             #  ########   ### #        #                

#             #                 #        #                
#             ###################        #                
#     #####                     ]        #                
#       ######                           #                
#        ########                  ]     #                
#                                        #                
##########################################                
 
