                                                          
      #####                     #                         
        ######                  #                         
         ######                 #                         
                                       
      #####                                               
        ######                                            
         ########                                         
                                                          
                                                          
